S W 0 0 0
0 W 0 W 0
0 W 0 W 0
0 W 0 W 0
0 0 0 W E